NO ./Textures/Ndum.txt
SO ./Textures/Sdum.txt
WE ./Textures/Wdum.txt
EA ./Textures/Edum.txt

F 20,1,1
C 200,1,1

11111111111111111111111111111
10000000000000000000000000001
10111000000000000000000000001
101N1000000000000000000000001
10111000000000000000000000001
10000000000000000000000000001
10000000000000000000000000001
10000000000000000000000000001
10000000000000000000000000001
10000000000000000000000000001
10000000000000000000000000001
10000000000000000000000000001
10000000000000000000000000001
11111111111111111111111111111