NO ./Textures/Ndum.txt
SO ./Textures/Sdum.txt
WE ./Textures/Wdum.txt
EA ./Textures/Edum.txt

11111111111111111
10000000000000001
10100000100000101
10000000000000001
11111000000111111
    10000001
    10100011
    10001111
    10001 11
    10001111
    10001001
    10000001
  111000001111  
  100000000001  
  100001100N01  
  100001100001  
  111111111111 


F 111,111,111
C 155,100,160