NO ./Textures/Ndum.txt
SO ./Textures/Sdum.txt
WE ./Textures/Wdum.txt
EA ./Textures/Edum.txt

F 220,100,0
C 225,30,0

        1111111111111111111111111
        1000000000110000000000001
        1011000001110000000000001
        1001000000000000000000001
111111111011000001110000000000001111
100000000011000001110111111111111001
111101111111110111000000100000111101
11110111111111011101010010001    101
11000000110101011100000010001    101
10000000000000001100000010001    001
10000000000000001101010010001    111
11000001110101011111011110N0111
11110111 1110101 101111010001
11111111 1111111 111111111111