NO ./Textures/North.xpm
SO ./Textures/South.xpm
WE ./Textures/West.xpm
EA ./Textures/East.xpm

F 20,1,1
C 200,1,1

11111111
1 1000011
1110010111
10E00101  1111111111111111111111111111111111111111
11110101  101                          110001110111
10110111111011111111111111111111111111100000000111111
10000000000011111111111111000101110000000111101  111111
11101111110111111111111111010100000111111111101111111111
10000000110111111111111111010111010111111110000000111111
111111100000000000000000000100000100000011111101011   1
1  111001111111111111111111111111111111000000000011111
1 100001                               1111111111
1110001
100001
11111