NO ./Textures/Monkey.xpm
SO ./Textures/Racoon.xpm
WE ./Textures/Cat.xpm
EA ./Textures/Dog.xpm

F 255,255,255
C 0,0,110

111111
1 1011
111011
10N001
111111