NO ./Textures/Monkey.xpm
SO ./Textures/Racoon.xpm
NO ./Textures/Monkey.xpm
NO ./Textures/Monkey.xpm

F 255,1,0
C 0,1,0

111111
1 1011
111011
10W001
111111