NO ./Textures/Monkey.xpm
SO ./Textures/Racoon.xpm
WE ./Textures/Cat.xpm
EA ./Textures/Dog.xpm

F 255,1,0
C 0,,0

111111
1 1011
111011
10W001
111111