NO ./Textures/Monkey.xpm
SO ./Textures/Racoon.xpm
WE ./Textures/Cat.xpm
EA ./Textures/Dog.xpm

F 255,0,200
C 225,30,0

        1111111111111111111111111
        1000000000110000000000001
        1011000001110000010000001
        10010000000000001 1000001
111111111011000001110000010000001111
100000000011000001110111111111111001
111101111111110111000000100001111001
11110111111111011101010010001    101
11000000110101011100000010001    111
10000000000000001100000010001    101
10000000000000001101010010001    111
11000001110101011111011110N001
11110111 1110101 10111101000011
11111111 1111111 1111111111111
